[
	{
		"name": "Forest 001",
		"tileset": {
			"name": "outdoor"
		},
		"width": 40,
		"height": 30,
		"tiles": [
			[ 4,  4,  4,  4,  4,  4, 14, 14,  4,  4,  4,  4,  4,  4,  4,  4,  4,  4,  4,  4, 24,  4,  4,  4,  4,  4,  4,  4,  4,  4,  4,  4,  4,  4,  4,  4,  4,  4,  4,  4],
		    [ 4,  4, 14,  4,  4,  4, 24, 14,  4,  4,  4,  4,  4,  4,  4,  4, 14, 14,  4,  4, 24,  4,  4,  4,  4,  4,  4,  4,  4,  4,  4,  4,  4,  4,  4,  4,  4,  4,  4,  4],
		    [ 4, 14, 14,  4,  4, 24,  4,  4, 14,  4,  4,  4,  4,  4,  4,  4,  4, 14,  4,  4, 24,  4,  4,  4,  4,  4,  4,  4,  4,  4,  4,  4,  4,  4,  4,  4,  4,  4,  4,  4],
		    [ 4, 14,  4,  1,  2,  3,  4,  4,  4, 24,  4,  4, 14,  4,  4,  4,  4,  4,  4,  4, 24,  4,  4,  4,  4,  4,  4,  4,  4,  4,  4,  4,  4,  4,  4,  4,  4,  4,  4,  4],
		    [ 4,  4,  4, 11,  5,  7,  2,  2,  3,  4,  4,  4,  4,  4,  4,  4,  4,  4,  4,  4, 24,  4,  4,  4,  4,  4,  4,  4,  4,  4,  4,  4,  4,  4,  4,  4,  4,  4,  4,  4],
		    [ 4,  4,  4, 21, 16,  5, 15, 15,  7,  3,  4,  4,  4, 14,  4,  4,  4,  4,  4,  4, 24,  4,  4,  4,  4,  4,  4,  4,  4,  4,  4,  4,  4,  4,  4,  4,  4,  4,  4,  4],
		    [ 4,  4,  4,  4, 21, 22, 16, 25, 25, 13,  4,  4,  4, 14,  4,  4,  4, 14,  4,  4, 24,  4,  4,  4,  4,  4,  4,  4,  4,  4,  4,  4,  4,  4,  4,  4,  4,  4,  4,  4],
		    [ 4,  4,  4,  4,  4,  4, 21, 16, 25, 13,  4,  4,  4,  4,  4,  4,  4,  4,  4,  4, 24,  4,  4,  4,  4,  4,  4,  4,  4,  4,  4,  4,  4,  4,  4,  4,  4,  4,  4,  4],
		    [ 4,  4,  4,  4,  1,  2,  3, 21, 22, 23,  4,  4,  4,  4,  4,  4,  4,  4,  4,  4, 24,  4,  4,  4,  4,  4,  4,  4,  4,  4,  4,  4,  4,  4,  4,  4,  4,  4,  4,  4],
		    [ 4,  4,  4,  4, 11,  5, 13,  4,  4,  4,  4,  4,  4,  4,  4,  4, 14,  4,  4,  4, 24,  4,  4,  4,  4,  4,  4,  4,  4,  4,  4,  4,  4,  4,  4,  4,  4,  4,  4,  4],
		    [ 4,  4,  4,  4, 21, 22, 23,  4,  4,  4, 24,  4,  4,  4,  4,  4,  4,  4,  4,  4, 24,  4,  4,  4,  4,  4,  4,  4,  4,  4,  4,  4,  4,  4,  4,  4,  4,  4,  4,  4],
		    [ 4,  4,  4,  4, 24,  4,  4,  4,  4, 24, 14,  4,  4,  4, 14,  4,  4,  4,  4,  4, 24,  4,  4,  4,  4,  4,  4,  4,  4,  4,  4,  4,  4,  4,  4,  4,  4,  4,  4,  4],
		    [ 4,  4, 24, 24,  4,  4,  4,  4,  4,  4,  4,  4,  4,  4,  4, 14,  4,  4,  4,  4, 24,  4,  4,  4,  4,  4,  4,  4,  4,  4,  4,  4,  4,  4,  4,  4,  4,  4,  4,  4],
		    [ 4,  4,  4, 24,  4,  4,  4,  4, 24,  4, 24,  4,  4,  4,  4,  4,  4,  4,  4,  4, 24,  4,  4,  4,  4,  4,  4,  4,  4,  4,  4,  4,  4,  4,  4,  4,  4,  4,  4,  4],
		    [ 4,  4,  4,  4,  4,  4,  4,  4,  4,  4,  4, 24,  4,  4,  4,  4,  4,  4,  4,  4, 24,  4,  4,  4,  4,  4,  4,  4,  4,  4,  4,  4,  4,  4,  4,  4,  4,  4,  4,  4],
			[14, 14, 14, 14, 14, 14, 14, 14, 14, 14, 14, 14, 14, 14, 14, 14, 14, 14, 14, 14, 24, 14, 14, 14, 14, 14, 14, 14, 14, 14, 14, 14, 14, 14, 14, 14, 14, 14, 14, 14],
			[ 4,  4,  4,  4,  4,  4,  4,  4,  4,  4,  4, 24,  4,  4,  4,  4,  4,  4,  4,  4, 24,  4,  4,  4,  4,  4,  4,  4,  4,  4,  4,  4,  4,  4,  4,  4,  4,  4,  4,  4],
			[ 4,  4,  4,  4,  4,  4,  4,  4,  4,  4,  4, 24,  4,  4,  4,  4,  4,  4,  4,  4, 24,  4,  4,  4,  4,  4,  4,  4,  4,  4,  4,  4,  4,  4,  4,  4,  4,  4,  4,  4],
			[ 4,  4,  4,  4,  4,  4,  4,  4,  4,  4,  4, 24,  4,  4,  4,  4,  4,  4,  4,  4, 24,  4,  4,  4,  4,  4,  4,  4,  4,  4,  4,  4,  4,  4,  4,  4,  4,  4,  4,  4],
			[ 4,  4,  4,  4,  4,  4,  4,  4,  4,  4,  4, 24,  4,  4,  4,  4,  4,  4,  4,  4, 24,  4,  4,  4,  4,  4,  4,  4,  4,  4,  4,  4,  4,  4,  4,  4,  4,  4,  4,  4],
			[ 4,  4,  4,  4,  4,  4,  4,  4,  4,  4,  4, 24,  4,  4,  4,  4,  4,  4,  4,  4, 24,  4,  4,  4,  4,  4,  4,  4,  4,  4,  4,  4,  4,  4,  4,  4,  4,  4,  4,  4],
			[ 4,  4,  4,  4,  4,  4,  4,  4,  4,  4,  4, 24,  4,  4,  4,  4,  4,  4,  4,  4, 24,  4,  4,  4,  4,  4,  4,  4,  4,  4,  4,  4,  4,  4,  4,  4,  4,  4,  4,  4],
			[ 4,  4,  4,  4,  4,  4,  4,  4,  4,  4,  4, 24,  4,  4,  4,  4,  4,  4,  4,  4, 24,  4,  4,  4,  4,  4,  4,  4,  4,  4,  4,  4,  4,  4,  4,  4,  4,  4,  4,  4],
			[ 4,  4,  4,  4,  4,  4,  4,  4,  4,  4,  4, 24,  4,  4,  4,  4,  4,  4,  4,  4, 24,  4,  4,  4,  4,  4,  4,  4,  4,  4,  4,  4,  4,  4,  4,  4,  4,  4,  4,  4],
			[ 4,  4,  4,  4,  4,  4,  4,  4,  4,  4,  4, 24,  4,  4,  4,  4,  4,  4,  4,  4, 24,  4,  4,  4,  4,  4,  4,  4,  4,  4,  4,  4,  4,  4,  4,  4,  4,  4,  4,  4],
			[ 4,  4,  4,  4,  4,  4,  4,  4,  4,  4,  4, 24,  4,  4,  4,  4,  4,  4,  4,  4, 24,  4,  4,  4,  4,  4,  4,  4,  4,  4,  4,  4,  4,  4,  4,  4,  4,  4,  4,  4],
			[ 4,  4,  4,  4,  4,  4,  4,  4,  4,  4,  4, 24,  4,  4,  4,  4,  4,  4,  4,  4, 24,  4,  4,  4,  4,  4,  4,  4,  4,  4,  4,  4,  4,  4,  4,  4,  4,  4,  4,  4],
			[ 4,  4,  4,  4,  4,  4,  4,  4,  4,  4,  4, 24,  4,  4,  4,  4,  4,  4,  4,  4, 24,  4,  4,  4,  4,  4,  4,  4,  4,  4,  4,  4,  4,  4,  4,  4,  4,  4,  4,  4],
			[ 4,  4,  4,  4,  4,  4,  4,  4,  4,  4,  4, 24,  4,  4,  4,  4,  4,  4,  4,  4, 24,  4,  4,  4,  4,  4,  4,  4,  4,  4,  4,  4,  4,  4,  4,  4,  4,  4,  4,  4],
			[ 4,  4,  4,  4,  4,  4,  4,  4,  4,  4,  4, 24,  4,  4,  4,  4,  4,  4,  4,  4, 24,  4,  4,  4,  4,  4,  4,  4,  4,  4,  4,  4,  4,  4,  4,  4,  4,  4,  4,  4]
		]
	}
]
